装配区 内存条_1 内存条插槽 插槽固定 对准	对准4 位姿获取 位置获取 姿态角匹配
物料区 usb_3 USB公头 公母匹配 检测	检测1 区域检测 位置获取 几何形状获取
物料区 屏幕2 屏幕 公母匹配 趋近	趋近1 位置获取 斜移
装配区 前摄1 前摄孔 公母匹配 趋近	趋近3 位置获取 斜移
物料区 CPU_6 CPU 插槽固定 提	提1 竖移 缓慢 吸盘
装配区 马达_2 马达槽 公母匹配	检测 趋近 对准 插
装配区 CPU_4 CPU插槽 插槽固定 趋近	趋近3 位置获取 斜移
物料区 电池连接器3 电池 公母匹配 抓取	抓取1 关闭夹爪 夹爪1 竖移 缓慢
中转区 sim卡托2 二次定位台 贴合定位台 调姿	调姿3 位姿获取 姿态角匹配
中转区 软排线_3 二次定位台 贴合定位台	检测 趋近 调姿 放 吸取 提
物料区 高压连接器8 线束 公母匹配 趋近	趋近1 位置获取 斜移
装配区 马达_2 马达槽 公母匹配 插	插4 位姿获取 位置获取 姿态角匹配 斜移
物料区 视频信号连接器_2 视频信号连接器_2公头 公母匹配 提	提2 竖移 缓慢 夹爪1
物料区 CPU_7 CPU 插槽固定 检测	检测1 区域检测 位置获取 几何形状获取
物料区 固态硬盘_3 固态硬盘_3外壳 公母匹配 趋近	趋近1 位置获取 斜移
装配区 usb_3 USB母座 公母匹配 插	插2 位姿获取 位置获取 姿态角匹配 斜移
装配区 软排线_2 软排线母头 公母匹配 检测	检测3 区域检测 位置获取 几何形状获取 装配方式检测
物料区 视频信号连接器_5 视频信号连接器_5公头 公母匹配 抓取	抓取1 关闭夹爪 夹爪1 竖移 缓慢
装配区 光纤连接器3 光纤连接器 公母匹配 对准	对准3 位姿获取 位置获取 姿态角匹配
装配区 CPU_4 CPU插槽 插槽固定 压	压2 打开推杆 平移 缓慢
物料区 电池连接器1 电池 公母匹配 抓取	抓取1 关闭夹爪 夹爪1 竖移 缓慢
装配区 PCB板_2 PCB板_2槽位 插槽固定	检测 趋近 对准 放 压
装配区 固态硬盘_4 PCI-E母头 公母匹配	检测 趋近 对准 插
装配区 视频信号连接器_3 视频信号连接器_3母座 公母匹配 插	插2 位姿获取 位置获取 姿态角匹配 斜移
装配区 马达_2 马达槽 公母匹配 检测	检测3 区域检测 位置获取 几何形状获取 装配方式检测
物料区 软管插头_1 软管插头 公母匹配 检测	检测1 区域检测 位置获取 几何形状获取
物料区 sim卡托2 sim卡托 公母匹配	检测 趋近 夹取 提
物料区 高压连接器6 线束 公母匹配 提	提3 竖移 缓慢 夹爪3
物料区 视频信号连接器_2 视频信号连接器_2公头 公母匹配 检测	检测1 区域检测 位置获取 几何形状获取
装配区 电池连接器3 电池连接器 公母匹配 对准	对准3 位姿获取 位置获取 姿态角匹配
中转区 软排线_1 二次定位台 贴合定位台 吸取	吸取1 打开吸盘 竖移 缓慢
物料区 手机电池1 手机电池 公母匹配 提	提4 竖移 缓慢 夹爪2
中转区 软排线_2 二次定位台 贴合定位台 吸取	吸取1 打开吸盘 竖移 缓慢
物料区 CPU_3 CPU 插槽固定	检测 趋近 吸取 提
物料区 航插_2 航空插头 公母匹配 提	提2 竖移 缓慢 夹爪1
中转区 软排线_2 二次定位台 贴合定位台 提	提1 竖移 缓慢 吸盘
中转区 后摄1 二次定位台 贴合定位台 调姿	调姿1 位姿获取 姿态角匹配
装配区 听筒_1 听筒 插槽固定 压	压2 打开推杆 竖移 缓慢
物料区 主板1 主板 公母匹配 检测	检测1 区域检测 位置获取 几何形状获取
物料区 CPU_3 CPU 插槽固定 检测	检测1 区域检测 位置获取 几何形状获取
中转区 听筒1 二次定位台 贴合定位台	检测 趋近 调姿 放 抓取 提
装配区 高压连接器7 高压连接器 公母匹配 插	插3 位姿获取 位置获取 姿态角匹配 斜移
物料区 听筒_1 听筒 插槽固定 检测	检测1 区域检测 位置获取 几何形状获取
装配区 屏幕2 中框 公母匹配 检测	检测3 区域检测 位置获取 几何形状获取 装配方式检测
装配区 usb_3 USB母座 公母匹配 检测	检测3 区域检测 位置获取 几何形状获取 装配方式检测
装配区 sim卡托1 sim卡槽 公母匹配 趋近	趋近3 位置获取 斜移
装配区 usb_4 USB母座 公母匹配 对准	对准2 位姿获取 位置获取 姿态角匹配
物料区 后摄1 后摄 公母匹配 检测	检测1 区域检测 位置获取 几何形状获取
中转区 后摄1 二次定位台 贴合定位台 趋近	趋近2 位置获取 斜移
物料区 软管插头_1 软管插头 公母匹配	检测 趋近 抓取 提
装配区 屏幕3 中框 公母匹配 对准	对准1 位姿获取 位置获取 姿态角匹配
装配区 手机电池3 手机电池槽 公母匹配 检测	检测3 区域检测 位置获取 几何形状获取 装配方式检测
装配区 高压连接器3 高压连接器 公母匹配	检测 趋近 对准 插
物料区 后盖2 后盖 公母匹配	检测 趋近 吸取 提
物料区 视频信号连接器_3 视频信号连接器_3公头 公母匹配 趋近	趋近1 位置获取 斜移
中转区 后摄1 二次定位台 贴合定位台 检测	检测2 区域检测 位置获取
装配区 软排线_1 软排线母头 公母匹配 对准	对准1 位姿获取 位置获取 姿态角匹配
物料区 高压连接器6 线束 公母匹配 检测	检测1 区域检测 位置获取 几何形状获取
物料区 航插_2 航空插头 公母匹配 抓取	抓取1 关闭夹爪 夹爪1 竖移 缓慢
物料区 固态硬盘_1 固态硬盘_1外壳 公母匹配 提	提2 竖移 缓慢 夹爪1
装配区 高压连接器4 高压连接器 公母匹配 检测	检测3 区域检测 位置获取 几何形状获取 装配方式检测
装配区 高压连接器6 高压连接器 公母匹配 检测	检测3 区域检测 位置获取 几何形状获取 装配方式检测
物料区 航插_1 航空插头 公母匹配 检测	检测1 区域检测 位置获取 几何形状获取
中转区 软排线_1 二次定位台 贴合定位台 趋近	趋近2 位置获取 斜移
装配区 高压连接器6 高压连接器 公母匹配	检测 趋近 对准 插
装配区 软排线_2 软排线母头 公母匹配 趋近	趋近3 位置获取 斜移
物料区 高压连接器8 线束 公母匹配 提	提3 竖移 缓慢 夹爪3
物料区 内存条_1 内存条 插槽固定 检测	检测1 区域检测 位置获取 几何形状获取
装配区 软排线_3 软排线母头 公母匹配 对准	对准1 位姿获取 位置获取 姿态角匹配
装配区 电池连接器3 电池连接器 公母匹配 趋近	趋近3 位置获取 斜移
物料区 手机电池1 手机电池 公母匹配 检测	检测1 区域检测 位置获取 几何形状获取
物料区 听筒_1 听筒 插槽固定	检测 趋近 吸取 提
中转区 听筒1 二次定位台 贴合定位台 提	提4 竖移 缓慢 夹爪2
装配区 din连接器1 din连接器母头 公母匹配	检测 趋近 对准 插
物料区 CPU_7 CPU 插槽固定 提	提1 竖移 缓慢 吸盘
物料区 电池连接器6 电池 公母匹配 提	提2 竖移 缓慢 夹爪1
装配区 手机电池3 手机电池槽 公母匹配	检测 趋近 对准 放 压
物料区 小板盖1 小板盖 公母匹配 检测	检测1 区域检测 位置获取 几何形状获取
装配区 光纤连接器3 光纤连接器 公母匹配 趋近	趋近3 位置获取 斜移
装配区 CPU_3 CPU插槽 插槽固定 检测	检测3 区域检测 位置获取 几何形状获取 装配方式检测
装配区 软排线_4 软排线母头 公母匹配 趋近	趋近3 位置获取 斜移
装配区 CPU_6 CPU插槽 插槽固定 压	压2 打开推杆 竖移 缓慢
物料区 高压连接器1 线束 公母匹配 提	提2 竖移 缓慢 夹爪1
装配区 视频信号连接器_2 视频信号连接器_2母座 公母匹配	检测 趋近 对准 插
物料区 后盖2 后盖 公母匹配 趋近	趋近1 位置获取 斜移
物料区 高压连接器3 线束 公母匹配 检测	检测1 区域检测 位置获取 几何形状获取
物料区 CPU_8 CPU 插槽固定 提	提1 竖移 缓慢 吸盘
装配区 固态硬盘_1 SATA母头 公母匹配 检测	检测3 区域检测 位置获取 几何形状获取 装配方式检测
物料区 sim卡托1 sim卡托 公母匹配 趋近	趋近1 位置获取 斜移
物料区 照明连接器_2 照明连接器_2公头 公母匹配	检测 趋近 抓取 提
物料区 高压连接器7 线束 公母匹配 提	提3 竖移 缓慢 夹爪3
物料区 软排线_3 软排线公头 公母匹配 吸取	吸取1 打开吸盘 竖移 缓慢
物料区 后盖3 后盖 公母匹配	检测 趋近 吸取 提
物料区 usb_2 USB公头 公母匹配 检测	检测1 区域检测 位置获取 几何形状获取
装配区 听筒_1 听筒 插槽固定 趋近	趋近3 位置获取 斜移
装配区 视频信号连接器_3 视频信号连接器_3母座 公母匹配	检测 趋近 对准 插
物料区 固态硬盘_4 固态硬盘_3外壳 公母匹配 检测	检测1 区域检测 位置获取 几何形状获取
物料区 电池连接器4 电池 公母匹配	检测 趋近 抓取 提
中转区 sim卡托2 二次定位台 贴合定位台	检测 趋近 调姿 放 夹取 提
物料区 高压连接器10 线束 公母匹配 提	提3 竖移 缓慢 夹爪3
物料区 固态硬盘_4 固态硬盘_3外壳 公母匹配	检测 趋近 夹取 提
中转区 前摄2 二次定位台 贴合定位台 趋近	趋近2 位置获取 斜移
物料区 CPU_8 CPU 插槽固定 检测	检测1 区域检测 位置获取 几何形状获取
装配区 CPU_3 CPU插槽 插槽固定 对准	对准1 位姿获取 位置获取 姿态角匹配
中转区 同轴线_1 二次定位台 贴合定位台 提	提3 竖移 缓慢 夹爪3
物料区 光纤连接器4 光纤 公母匹配	检测 趋近 抓取 提
装配区 视频信号连接器_5 视频信号连接器_5母座 公母匹配 插	插2 位姿获取 位置获取 姿态角匹配 斜移
物料区 固态硬盘_3 固态硬盘_3外壳 公母匹配	检测 趋近 夹取 提
装配区 usb_2 USB母座 公母匹配 对准	对准2 位姿获取 位置获取 姿态角匹配
物料区 软排线_3 软排线公头 公母匹配	检测 趋近 吸取 提
装配区 din连接器2 din连接器母头 公母匹配 对准	对准3 位姿获取 位置获取 姿态角匹配
中转区 软排线_2 二次定位台 贴合定位台 趋近	趋近2 位置获取 斜移
物料区 LSA连接器_1 LSA插头 公母匹配 趋近	趋近1 位置获取 斜移
物料区 手机电池_1 手机电池 插槽固定 提	提2 竖移 缓慢 夹爪1
物料区 航插_2 航空插头 公母匹配 趋近	趋近1 位置获取 斜移
物料区 电池连接器6 电池 公母匹配 检测	检测1 区域检测 位置获取 几何形状获取
物料区 高压连接器10 线束 公母匹配 趋近	趋近1 位置获取 斜移
物料区 sim卡托1 sim卡托 公母匹配	检测 趋近 夹取 提
装配区 航插_1 航空插座 公母匹配 插	插4 位姿获取 位置获取 姿态角匹配 斜移
物料区 din连接器1 din连接器公头 公母匹配 趋近	趋近1 位置获取 斜移
物料区 CPU_10 CPU 插槽固定 提	提1 竖移 缓慢 吸盘
装配区 电池连接器3 电池连接器 公母匹配	检测 趋近 对准 插
物料区 固态硬盘_1 固态硬盘_1外壳 公母匹配 抓取	抓取2 关闭夹爪 夹爪2 竖移 缓慢
装配区 后盖3 中框 公母匹配	检测 趋近 对准 放 压
中转区 主板1 二次定位台 贴合定位台	检测 趋近 调姿 放 抓取 提
装配区 电池连接器1 电池连接器 公母匹配 检测	检测3 区域检测 位置获取 几何形状获取 装配方式检测
装配区 照明连接器_1 照明连接器_1母座 公母匹配 趋近	趋近3 位置获取 斜移
装配区 光纤连接器1 光纤连接器 公母匹配 对准	对准3 位姿获取 位置获取 姿态角匹配
物料区 高压连接器10 线束 公母匹配	检测 趋近 夹取 提
装配区 高压连接器8 高压连接器 公母匹配 对准	对准3 位姿获取 位置获取 姿态角匹配
装配区 高压连接器5 高压连接器 公母匹配 检测	检测3 区域检测 位置获取 几何形状获取 装配方式检测
装配区 扬声器模块_1 扬声器模块 插槽固定 趋近	趋近3 位置获取 斜移
装配区 扬声器模块_1 扬声器模块 插槽固定 对准	对准1 位姿获取 位置获取 姿态角匹配
装配区 电池连接器2 电池连接器 公母匹配	检测 趋近 对准 插
物料区 高压连接器9 线束 公母匹配 抓取	抓取1 关闭夹爪 夹爪1 竖移 缓慢
物料区 内存条_1 内存条 插槽固定	检测 趋近 夹取 提
装配区 CPU_9 CPU插槽 插槽固定 对准	对准1 位姿获取 位置获取 姿态角匹配
装配区 手机电池2 手机电池槽 公母匹配 对准	对准1 位姿获取 位置获取 姿态角匹配
装配区 光纤连接器4 光纤连接器 公母匹配 对准	对准3 位姿获取 位置获取 姿态角匹配
物料区 usb_3 USB公头 公母匹配	检测 趋近 抓取 提
装配区 高压连接器4 高压连接器 公母匹配 插	插4 位姿获取 位置获取 姿态角匹配 斜移
物料区 螺丝_1 螺丝_1 孔轴连接 检测	检测1 区域检测 位置获取 几何形状获取
物料区 高压连接器9 线束 公母匹配 趋近	趋近1 位置获取 斜移
物料区 光纤连接器1 光纤 公母匹配	检测 趋近 抓取 提
装配区 光纤连接器5 光纤连接器 公母匹配 趋近	趋近3 位置获取 斜移
物料区 高压连接器3 线束 公母匹配	检测 趋近 夹取 提
物料区 sim卡托1 sim卡托 公母匹配 提	提3 竖移 缓慢 夹爪3
物料区 小板盖1 小板盖 公母匹配 提	提1 竖移 缓慢 吸盘
装配区 照明连接器_2 照明连接器_2母座 公母匹配 检测	检测3 区域检测 位置获取 几何形状获取 装配方式检测
装配区 电池连接器2 电池连接器 公母匹配 检测	检测3 区域检测 位置获取 几何形状获取 装配方式检测
中转区 软排线_4 二次定位台 贴合定位台 检测	检测2 区域检测 位置获取
物料区 视频信号连接器_5 视频信号连接器_5公头 公母匹配 检测	检测1 区域检测 位置获取 几何形状获取
中转区 后摄1 二次定位台 贴合定位台	检测 趋近 调姿 放 吸取 提
物料区 后摄2 后摄 公母匹配 趋近	趋近1 位置获取 斜移
装配区 软管插头_1 软管插座 公母匹配	检测 趋近 对准 插 旋
物料区 航插_1 航空插头 公母匹配 提	提2 竖移 缓慢 夹爪1
物料区 usb_4 USB公头 公母匹配 提	提2 竖移 缓慢 夹爪1
物料区 照明连接器_1 照明连接器_1公头 公母匹配 趋近	趋近1 位置获取 斜移
装配区 马达_2 马达槽 公母匹配 对准	对准3 位姿获取 位置获取 姿态角匹配
装配区 光纤连接器1 光纤连接器 公母匹配 插	插4 位姿获取 位置获取 姿态角匹配 斜移
装配区 视频信号连接器_4 视频信号连接器_4母座 公母匹配	检测 趋近 对准 插
中转区 软排线_1 二次定位台 贴合定位台 检测	检测2 区域检测 位置获取
装配区 高压连接器10 高压连接器 公母匹配	检测 趋近 对准 插 推
物料区 照明连接器_1 照明连接器_1公头 公母匹配 提	提2 竖移 缓慢 夹爪1
物料区 照明连接器_3 照明连接器_3公头 公母匹配 提	提2 竖移 缓慢 夹爪1
物料区 电池连接器6 电池 公母匹配 趋近	趋近1 位置获取 斜移
装配区 高压连接器8 高压连接器 公母匹配 趋近	趋近3 位置获取 斜移
物料区 光纤连接器1 光纤 公母匹配 趋近	趋近1 位置获取 斜移
物料区 电源键_1 电源键 插槽固定 趋近	趋近1 位置获取 斜移
中转区 后摄1 二次定位台 贴合定位台 提	提1 竖移 缓慢 吸盘
中转区 软排线_3 二次定位台 贴合定位台 检测	检测2 区域检测 位置获取
装配区 电池连接器6 电池连接器 公母匹配 检测	检测3 区域检测 位置获取 几何形状获取 装配方式检测
装配区 固态硬盘_3 M.2母头 公母匹配 插	插5 位姿获取 位置获取 姿态角匹配 斜移
装配区 高压连接器9 高压连接器 公母匹配 趋近	趋近3 位置获取 斜移
装配区 高压连接器3 高压连接器 公母匹配 检测	检测3 区域检测 位置获取 几何形状获取 装配方式检测
装配区 听筒_1 听筒 插槽固定	检测 趋近 对准 放 压
装配区 螺丝_1 装配孔 孔轴连接	检测 趋近 对准 插 拧
装配区 CPU_7 CPU插槽 插槽固定 趋近	趋近3 位置获取 斜移
物料区 软排线_1 软排线公头 公母匹配	检测 趋近 吸取 提
物料区 马达_2 马达 公母匹配 提	提2 竖移 缓慢 夹爪1
装配区 航插_2 航空插座 公母匹配	检测 趋近 对准 插
装配区 前摄1 前摄孔 公母匹配	检测 趋近 对准 放 压
装配区 前摄2 前摄孔 公母匹配 对准	对准1 位姿获取 位置获取 姿态角匹配
物料区 听筒1 听筒 公母匹配	检测 趋近 抓取 提
物料区 PCB板_1 PCB板_1 插槽固定 趋近	趋近1 位置获取 斜移
物料区 视频信号连接器_1 视频信号连接器_1公头 公母匹配	检测 趋近 抓取 提
中转区 同轴线_1 二次定位台 贴合定位台 趋近	趋近2 位置获取 斜移
物料区 软排线_2 软排线公头 公母匹配 检测	检测1 区域检测 位置获取 几何形状获取
装配区 PCB板_1 PCB板_1槽位 插槽固定 压	压2 打开推杆 竖移 缓慢
装配区 CPU_10 CPU插槽 插槽固定 压	压2 打开推杆 竖移 缓慢
物料区 sim卡托2 sim卡托 公母匹配 检测	检测1 区域检测 位置获取 几何形状获取
物料区 前摄1 前摄 公母匹配 检测	检测1 区域检测 位置获取 几何形状获取
物料区 软排线_3 软排线公头 公母匹配 趋近	趋近1 位置获取 斜移
装配区 电池连接器5 电池连接器 公母匹配 插	插4 位姿获取 位置获取 姿态角匹配 斜移
物料区 光纤连接器5 光纤 公母匹配 抓取	抓取1 关闭夹爪 夹爪1 竖移 缓慢
物料区 手机电池1 手机电池 公母匹配 趋近	趋近1 位置获取 斜移
物料区 听筒_1 听筒 插槽固定 提	提1 竖移 缓慢 吸盘
装配区 sim卡托1 sim卡槽 公母匹配 对准	对准4 位姿获取 位置获取 姿态角匹配
物料区 电池连接器1 电池 公母匹配 提	提2 竖移 缓慢 夹爪1
装配区 光纤连接器3 光纤连接器 公母匹配	检测 趋近 对准 插
物料区 光纤连接器3 光纤 公母匹配 抓取	抓取1 关闭夹爪 夹爪1 竖移 缓慢
装配区 CPU_8 CPU插槽 插槽固定 检测	检测3 区域检测 位置获取 几何形状获取 装配方式检测
装配区 CPU_1 CPU插槽 插槽固定 压	压2 打开推杆 竖移 缓慢
物料区 LSA连接器_1 LSA插头 公母匹配 提	提2 竖移 缓慢 夹爪1
装配区 视频信号连接器_2 视频信号连接器_2母座 公母匹配 插	插2 位姿获取 位置获取 姿态角匹配 斜移
物料区 螺丝_1 螺丝_1 孔轴连接 提	提2 竖移 缓慢 夹爪1
物料区 CPU_4 CPU 插槽固定 吸取	吸取2 打开吸盘 竖移 缓慢
装配区 电池连接器5 电池连接器 公母匹配 检测	检测3 区域检测 位置获取 几何形状获取 装配方式检测
物料区 光纤连接器2 光纤 公母匹配	检测 趋近 抓取 提
装配区 固态硬盘_4 PCI-E母头 公母匹配 插	插5 位姿获取 位置获取 姿态角匹配 斜移
装配区 航插_1 航空插座 公母匹配 检测	检测3 区域检测 位置获取 几何形状获取 装配方式检测
装配区 视频信号连接器_4 视频信号连接器_4母座 公母匹配 检测	检测3 区域检测 位置获取 几何形状获取 装配方式检测
中转区 软排线_3 二次定位台 贴合定位台 调姿	调姿1 位姿获取 姿态角匹配
装配区 usb_4 USB母座 公母匹配	检测 趋近 对准 插
物料区 usb_4 USB公头 公母匹配	检测 趋近 抓取 提
物料区 后盖1 后盖 公母匹配 检测	检测1 区域检测 位置获取 几何形状获取
装配区 小板盖1 中框 公母匹配 压	压3 打开推杆 竖移 缓慢
装配区 CPU_2 CPU插槽 插槽固定	检测 趋近 对准 放 压
中转区 软排线_3 二次定位台 贴合定位台 趋近	趋近2 位置获取 斜移
装配区 咬接铆钉_1 装配孔 孔轴连接	检测 趋近 对准 插
物料区 sim卡托2 sim卡托 公母匹配 趋近	趋近1 位置获取 斜移
物料区 视频信号连接器_2 视频信号连接器_2公头 公母匹配	检测 趋近 抓取 提
物料区 照明连接器_3 照明连接器_3公头 公母匹配 抓取	抓取1 关闭夹爪 夹爪1 竖移 缓慢
中转区 主板1 二次定位台 贴合定位台 调姿	调姿4 位姿获取 姿态角匹配
物料区 主板1 主板 公母匹配 抓取	抓取2 关闭夹爪 夹爪2 竖移 缓慢
装配区 听筒1 听筒孔 公母匹配 压	压3 打开推杆 竖移 缓慢
装配区 螺丝_1 装配孔 孔轴连接 对准	对准3 位姿获取 位置获取 姿态角匹配
物料区 视频信号连接器_4 视频信号连接器_4公头 公母匹配 抓取	抓取1 关闭夹爪 夹爪1 竖移 缓慢
物料区 主板1 主板 公母匹配 提	提4 竖移 缓慢 夹爪2
装配区 CPU_10 CPU插槽 插槽固定 检测	检测3 区域检测 位置获取 几何形状获取 装配方式检测
装配区 sim卡托2 sim卡槽 公母匹配 对准	对准4 位姿获取 位置获取 姿态角匹配
装配区 din连接器3 din连接器母头 公母匹配 趋近	趋近3 位置获取 斜移
物料区 usb_5 USB公头 公母匹配 提	提2 竖移 缓慢 夹爪1
中转区 后摄1 二次定位台 贴合定位台 吸取	吸取2 打开吸盘 竖移 缓慢
装配区 sim卡托1 sim卡槽 公母匹配	检测 趋近 对准 插
物料区 屏幕3 屏幕 公母匹配	检测 趋近 吸取 提
装配区 高压连接器4 高压连接器 公母匹配 对准	对准3 位姿获取 位置获取 姿态角匹配
物料区 后盖3 后盖 公母匹配 提	提1 竖移 缓慢 吸盘
物料区 手机电池4 手机电池 公母匹配 检测	检测1 区域检测 位置获取 几何形状获取
物料区 usb_5 USB公头 公母匹配 趋近	趋近1 位置获取 斜移
装配区 sim卡托1 sim卡槽 公母匹配 插	插5 位姿获取 位置获取 姿态角匹配 斜移
物料区 CPU_3 CPU 插槽固定 趋近	趋近1 位置获取 斜移
装配区 以太网连接器_1 Rj45插孔 公母匹配 插	插2 位姿获取 位置获取 姿态角匹配 斜移
装配区 后盖2 中框 公母匹配 对准	对准1 位姿获取 位置获取 姿态角匹配
装配区 同轴线_1 同轴线母座 公母匹配 检测	检测3 区域检测 位置获取 几何形状获取 装配方式检测
装配区 固态硬盘_4 PCI-E母头 公母匹配 趋近	趋近3 位置获取 斜移
物料区 sim卡托2 sim卡托 公母匹配 提	提3 竖移 缓慢 夹爪3
物料区 高压连接器7 线束 公母匹配 检测	检测1 区域检测 位置获取 几何形状获取
物料区 手机电池4 手机电池 公母匹配 吸取	吸取2 打开吸盘 竖移 缓慢
物料区 光纤连接器5 光纤 公母匹配	检测 趋近 抓取 提
物料区 扬声器模块_1 扬声器模块 插槽固定 提	提1 竖移 缓慢 吸盘
装配区 屏幕3 中框 公母匹配 压	压1 打开推杆 竖移 缓慢
物料区 高压连接器9 线束 公母匹配 检测	检测1 区域检测 位置获取 几何形状获取
物料区 听筒1 听筒 公母匹配 趋近	趋近1 位置获取 斜移
装配区 电池连接器3 电池连接器 公母匹配 检测	检测3 区域检测 位置获取 几何形状获取 装配方式检测
物料区 软排线_2 软排线公头 公母匹配 趋近	趋近1 位置获取 斜移
物料区 din连接器3 din连接器公头 公母匹配 检测	检测1 区域检测 位置获取 几何形状获取
装配区 光纤连接器2 光纤连接器 公母匹配	检测 趋近 对准 插
物料区 软排线_2 软排线公头 公母匹配	检测 趋近 吸取 提
装配区 手机电池4 手机电池槽 公母匹配 压	压3 打开推杆 竖移 缓慢
物料区 屏幕3 屏幕 公母匹配 趋近	趋近1 位置获取 斜移
装配区 后盖2 中框 公母匹配 趋近	趋近3 位置获取 斜移
装配区 CPU_4 CPU插槽 插槽固定	检测 趋近 对准 放 压
物料区 航插_2 航空插头 公母匹配	检测 趋近 抓取 提
装配区 高压连接器7 高压连接器 公母匹配 趋近	趋近3 位置获取 斜移
装配区 软排线_1 软排线母头 公母匹配	检测 趋近 对准 放 压
装配区 后摄2 后摄孔 公母匹配 趋近	趋近3 位置获取 斜移
装配区 CPU_7 CPU插槽 插槽固定 对准	对准1 位姿获取 位置获取 姿态角匹配
物料区 马达_1 马达 公母匹配 抓取	抓取1 关闭夹爪 夹爪1 竖移 缓慢
物料区 CPU_6 CPU 插槽固定 检测	检测1 区域检测 位置获取 几何形状获取
装配区 高压连接器4 高压连接器 公母匹配 趋近	趋近3 位置获取 斜移
装配区 视频信号连接器_2 视频信号连接器_2母座 公母匹配 检测	检测3 区域检测 位置获取 几何形状获取 装配方式检测
物料区 马达_2 马达 公母匹配 检测	检测1 区域检测 位置获取 几何形状获取
装配区 sim卡托2 sim卡槽 公母匹配 插	插5 位姿获取 位置获取 姿态角匹配 斜移
物料区 usb_1 USB公头 公母匹配 提	提2 竖移 缓慢 夹爪1
中转区 同轴线_1 二次定位台 贴合定位台 检测	检测2 区域检测 位置获取
物料区 前摄2 前摄 公母匹配 检测	检测1 区域检测 位置获取 几何形状获取
物料区 电池连接器5 电池 公母匹配 提	提2 竖移 缓慢 夹爪1
物料区 软排线_3 软排线公头 公母匹配 提	提1 竖移 缓慢 吸盘
装配区 CPU_2 CPU插槽 插槽固定 趋近	趋近3 位置获取 斜移
物料区 软管插头_1 软管插头 公母匹配 趋近	趋近1 位置获取 斜移
装配区 电池连接器4 电池连接器 公母匹配	检测 趋近 对准 插
装配区 高压连接器9 高压连接器 公母匹配 插	插4 位姿获取 位置获取 姿态角匹配 斜移
装配区 照明连接器_3 照明连接器_3母座 公母匹配 检测	检测3 区域检测 位置获取 几何形状获取 装配方式检测
物料区 视频信号连接器_4 视频信号连接器_4公头 公母匹配 趋近	趋近1 位置获取 斜移
装配区 软排线_3 软排线母头 公母匹配 趋近	趋近3 位置获取 斜移
装配区 光纤连接器1 光纤连接器 公母匹配 趋近	趋近3 位置获取 斜移
物料区 屏幕3 屏幕 公母匹配 提	提1 竖移 缓慢 吸盘
物料区 屏幕2 屏幕 公母匹配 提	提1 竖移 缓慢 吸盘
装配区 电池连接器5 电池连接器 公母匹配 对准	对准3 位姿获取 位置获取 姿态角匹配
装配区 后摄1 后摄孔 公母匹配 检测	检测3 区域检测 位置获取 几何形状获取 装配方式检测
装配区 CPU_6 CPU插槽 插槽固定 检测	检测3 区域检测 位置获取 几何形状获取 装配方式检测
中转区 前摄1 二次定位台 贴合定位台 吸取	吸取2 打开吸盘 竖移 缓慢
装配区 电池连接器2 电池连接器 公母匹配 插	插4 位姿获取 位置获取 姿态角匹配 斜移
物料区 内存条_1 内存条 插槽固定 提	提3 竖移 缓慢 夹爪3
装配区 小板盖1 中框 公母匹配 对准	对准1 位姿获取 位置获取 姿态角匹配
装配区 马达_2 马达槽 公母匹配 趋近	趋近3 位置获取 斜移
装配区 扬声器模块_1 扬声器模块 插槽固定 检测	检测3 区域检测 位置获取 几何形状获取 装配方式检测
物料区 视频信号连接器_4 视频信号连接器_4公头 公母匹配	检测 趋近 抓取 提
物料区 手机电池4 手机电池 公母匹配 提	提1 竖移 缓慢 吸盘
中转区 软排线_4 二次定位台 贴合定位台 调姿	调姿1 位姿获取 姿态角匹配
中转区 听筒1 二次定位台 贴合定位台 抓取	抓取2 关闭夹爪 夹爪2 竖移 缓慢
物料区 usb_1 USB公头 公母匹配 抓取	抓取1 关闭夹爪 夹爪1 竖移 缓慢
中转区 前摄1 二次定位台 贴合定位台 检测	检测2 区域检测 位置获取
物料区 手机电池4 手机电池 公母匹配 趋近	趋近1 位置获取 斜移
物料区 CPU_5 CPU 插槽固定 趋近	趋近1 位置获取 斜移
物料区 软排线_4 软排线公头 公母匹配 吸取	吸取1 打开吸盘 竖移 缓慢
物料区 高压连接器2 线束 公母匹配 提	提2 竖移 缓慢 夹爪1
物料区 照明连接器_2 照明连接器_2公头 公母匹配 提	提2 竖移 缓慢 夹爪1
物料区 光纤连接器2 光纤 公母匹配 趋近	趋近1 位置获取 斜移
装配区 sim卡托2 sim卡槽 公母匹配	检测 趋近 对准 插
装配区 手机电池2 手机电池槽 公母匹配 检测	检测3 区域检测 位置获取 几何形状获取 装配方式检测
装配区 咬接铆钉_1 装配孔 孔轴连接 趋近	趋近3 位置获取 斜移
装配区 屏幕1 中框 公母匹配	检测 趋近 对准 放 压
装配区 电池连接器1 电池连接器 公母匹配	检测 趋近 对准 插
物料区 CPU_3 CPU 插槽固定 提	提1 竖移 缓慢 吸盘
物料区 咬接铆钉_1 铆钉 孔轴连接 提	提2 竖移 缓慢 夹爪1
装配区 软排线_2 软排线母头 公母匹配 压	压1 打开推杆 竖移 缓慢
装配区 电池连接器1 电池连接器 公母匹配 对准	对准3 位姿获取 位置获取 姿态角匹配
物料区 usb_2 USB公头 公母匹配	检测 趋近 抓取 提
中转区 后摄2 二次定位台 贴合定位台 吸取	吸取2 打开吸盘 竖移 缓慢
物料区 PCB板_2 PCB板_2 插槽固定	检测 趋近 抓取 提
装配区 软管插头_1 软管插座 公母匹配 插	插4 位姿获取 位置获取 姿态角匹配 斜移
物料区 软排线_2 软排线公头 公母匹配 吸取	吸取1 打开吸盘 竖移 缓慢
物料区 以太网连接器_1 Rj45公头 公母匹配 提	提2 竖移 缓慢 夹爪1
物料区 sim卡托1 sim卡托 公母匹配 检测	检测1 区域检测 位置获取 几何形状获取
物料区 光纤连接器5 光纤 公母匹配 检测	检测1 区域检测 位置获取 几何形状获取
物料区 前摄1 前摄 公母匹配 吸取	吸取2 打开吸盘 竖移 缓慢
装配区 高压连接器2 高压连接器 公母匹配	检测 趋近 对准 插
物料区 电池连接器2 电池 公母匹配 抓取	抓取1 关闭夹爪 夹爪1 竖移 缓慢
中转区 后摄2 二次定位台 贴合定位台 趋近	趋近2 位置获取 斜移
装配区 CPU_2 CPU插槽 插槽固定 压	压2 打开推杆 竖移 缓慢
装配区 固态硬盘_2 mSATA母头 公母匹配 趋近	趋近3 位置获取 斜移
装配区 光纤连接器5 光纤连接器 公母匹配 插	插4 位姿获取 位置获取 姿态角匹配 斜移
物料区 前摄2 前摄 公母匹配	检测 趋近 吸取 提
物料区 屏幕2 屏幕 公母匹配 检测	检测1 区域检测 位置获取 几何形状获取
装配区 后摄1 后摄孔 公母匹配 压	压3 打开推杆 竖移 缓慢
装配区 软排线_4 软排线母头 公母匹配 对准	对准2 位姿获取 位置获取 姿态角匹配
物料区 高压连接器1 线束 公母匹配	检测 趋近 抓取 提
装配区 CPU_5 CPU插槽 插槽固定 压	压2 打开推杆 竖移 缓慢
装配区 前摄1 前摄孔 公母匹配 检测	检测3 区域检测 位置获取 几何形状获取 装配方式检测
装配区 高压连接器1 高压连接器 公母匹配	检测 趋近 对准 插
物料区 CPU_4 CPU 插槽固定 提	提1 竖移 缓慢 吸盘
装配区 din连接器2 din连接器母头 公母匹配	检测 趋近 对准 插
物料区 马达_2 马达 公母匹配 趋近	趋近1 位置获取 斜移
装配区 航插_1 航空插座 公母匹配	检测 趋近 对准 插
物料区 高压连接器7 线束 公母匹配 趋近	趋近1 位置获取 斜移
物料区 CPU_4 CPU 插槽固定 检测	检测1 区域检测 位置获取 几何形状获取
装配区 屏幕2 中框 公母匹配 趋近	趋近3 位置获取 斜移
物料区 后盖3 后盖 公母匹配 检测	检测1 区域检测 位置获取 几何形状获取
装配区 视频信号连接器_4 视频信号连接器_4母座 公母匹配 趋近	趋近3 位置获取 斜移
装配区 CPU_1 CPU插槽 插槽固定	检测 趋近 对准 放 压
装配区 咬接铆钉_1 装配孔 孔轴连接 检测	检测3 区域检测 位置获取 几何形状获取 装配方式检测
物料区 CPU_1 CPU 插槽固定 吸取	吸取2 打开吸盘 竖移 缓慢
物料区 光纤连接器2 光纤 公母匹配 抓取	抓取1 关闭夹爪 夹爪1 竖移 缓慢
装配区 手机电池1 手机电池槽 公母匹配 检测	检测3 区域检测 位置获取 几何形状获取 装配方式检测
装配区 高压连接器3 高压连接器 公母匹配 插	插3 位姿获取 位置获取 姿态角匹配 斜移
物料区 PCB板_2 PCB板_2 插槽固定 检测	检测1 区域检测 位置获取 几何形状获取
装配区 屏幕2 中框 公母匹配 压	压1 打开推杆 竖移 缓慢
物料区 din连接器2 din连接器公头 公母匹配 抓取	抓取1 关闭夹爪 夹爪1 竖移 缓慢
装配区 din连接器3 din连接器母头 公母匹配 插	插3 位姿获取 位置获取 姿态角匹配 斜移
物料区 usb_4 USB公头 公母匹配 趋近	趋近1 位置获取 斜移
装配区 照明连接器_3 照明连接器_3母座 公母匹配 趋近	趋近3 位置获取 斜移
物料区 光纤连接器3 光纤 公母匹配 提	提2 竖移 缓慢 夹爪1
装配区 电源键_1 电源键插槽 插槽固定	检测 趋近 对准 插
物料区 CPU_8 CPU 插槽固定	检测 趋近 吸取 提
中转区 sim卡托2 二次定位台 贴合定位台 提	提3 竖移 缓慢 夹爪3
物料区 din连接器3 din连接器公头 公母匹配	检测 趋近 夹取 提
装配区 航插_2 航空插座 公母匹配 趋近	趋近3 位置获取 斜移
物料区 CPU_9 CPU 插槽固定 提	提1 竖移 缓慢 吸盘
装配区 固态硬盘_1 SATA母头 公母匹配 插	插2 位姿获取 位置获取 姿态角匹配 斜移
物料区 屏幕1 屏幕 公母匹配 提	提1 竖移 缓慢 吸盘
物料区 后摄2 后摄 公母匹配 提	提1 竖移 缓慢 吸盘
物料区 usb_5 USB公头 公母匹配 抓取	抓取1 关闭夹爪 夹爪1 竖移 缓慢
物料区 后盖1 后盖 公母匹配 趋近	趋近1 位置获取 斜移
物料区 CPU_9 CPU 插槽固定 检测	检测1 区域检测 位置获取 几何形状获取
装配区 手机电池2 手机电池槽 公母匹配 趋近	趋近3 位置获取 斜移
装配区 CPU_4 CPU插槽 插槽固定 对准	对准1 位姿获取 位置获取 姿态角匹配
物料区 以太网连接器_1 Rj45公头 公母匹配 趋近	趋近1 位置获取 斜移
装配区 马达_1 马达槽 公母匹配 检测	检测3 区域检测 位置获取 几何形状获取 装配方式检测
装配区 CPU_5 CPU插槽 插槽固定 对准	对准1 位姿获取 位置获取 姿态角匹配
物料区 软排线_2 软排线公头 公母匹配 提	提1 竖移 缓慢 吸盘
装配区 电池连接器6 电池连接器 公母匹配 对准	对准3 位姿获取 位置获取 姿态角匹配
装配区 小板盖1 中框 公母匹配	检测 趋近 对准 放 压
装配区 视频信号连接器_5 视频信号连接器_5母座 公母匹配	检测 趋近 对准 插
物料区 航插_1 航空插头 公母匹配	检测 趋近 抓取 提
装配区 照明连接器_2 照明连接器_2母座 公母匹配 对准	对准2 位姿获取 位置获取 姿态角匹配
装配区 电池连接器2 电池连接器 公母匹配 趋近	趋近3 位置获取 斜移
装配区 航插_1 航空插座 公母匹配 对准	对准3 位姿获取 位置获取 姿态角匹配
物料区 电池连接器4 电池 公母匹配 趋近	趋近1 位置获取 斜移
装配区 软排线_1 软排线母头 公母匹配 检测	检测3 区域检测 位置获取 几何形状获取 装配方式检测
物料区 后摄2 后摄 公母匹配 检测	检测1 区域检测 位置获取 几何形状获取
物料区 手机电池2 手机电池 公母匹配 吸取	吸取2 打开吸盘 竖移 缓慢
装配区 光纤连接器5 光纤连接器 公母匹配	检测 趋近 对准 插 推
物料区 高压连接器10 线束 公母匹配 检测	检测1 区域检测 位置获取 几何形状获取
装配区 sim卡托1 sim卡槽 公母匹配 检测	检测3 区域检测 位置获取 几何形状获取 装配方式检测
装配区 电池连接器4 电池连接器 公母匹配 插	插4 位姿获取 位置获取 姿态角匹配 斜移
物料区 视频信号连接器_4 视频信号连接器_4公头 公母匹配 提	提2 竖移 缓慢 夹爪1
物料区 听筒1 听筒 公母匹配 提	提4 竖移 缓慢 夹爪2
装配区 CPU_1 CPU插槽 插槽固定 趋近	趋近3 位置获取 斜移
物料区 同轴线_1 同轴线公头 公母匹配	检测 趋近 夹取 提
物料区 LSA连接器_1 LSA插头 公母匹配 检测	检测1 区域检测 位置获取 几何形状获取
装配区 视频信号连接器_5 视频信号连接器_5母座 公母匹配 检测	检测3 区域检测 位置获取 几何形状获取 装配方式检测
物料区 电源键_1 电源键 插槽固定 提	提3 竖移 缓慢 夹爪3
装配区 高压连接器1 高压连接器 公母匹配 对准	对准3 位姿获取 位置获取 姿态角匹配
装配区 高压连接器2 高压连接器 公母匹配 趋近	趋近3 位置获取 斜移
物料区 软排线_1 软排线公头 公母匹配 吸取	吸取1 打开吸盘 竖移 缓慢
装配区 高压连接器7 高压连接器 公母匹配 对准	对准3 位姿获取 位置获取 姿态角匹配
物料区 光纤连接器2 光纤 公母匹配 提	提2 竖移 缓慢 夹爪1
物料区 光纤连接器1 光纤 公母匹配 抓取	抓取1 关闭夹爪 夹爪1 竖移 缓慢
物料区 电池连接器3 电池 公母匹配 趋近	趋近1 位置获取 斜移
装配区 电池连接器1 电池连接器 公母匹配 插	插4 位姿获取 位置获取 姿态角匹配 斜移
物料区 usb_2 USB公头 公母匹配 抓取	抓取1 关闭夹爪 夹爪1 竖移 缓慢
物料区 din连接器1 din连接器公头 公母匹配	检测 趋近 抓取 提
物料区 航插_1 航空插头 公母匹配 抓取	抓取1 关闭夹爪 夹爪1 竖移 缓慢
装配区 固态硬盘_1 SATA母头 公母匹配 对准	对准2 位姿获取 位置获取 姿态角匹配
物料区 光纤连接器1 光纤 公母匹配 提	提2 竖移 缓慢 夹爪1
装配区 后摄1 后摄孔 公母匹配	检测 趋近 对准 放 压
装配区 视频信号连接器_4 视频信号连接器_4母座 公母匹配 插	插2 位姿获取 位置获取 姿态角匹配 斜移
装配区 usb_2 USB母座 公母匹配 插	插2 位姿获取 位置获取 姿态角匹配 斜移
装配区 听筒_1 听筒 插槽固定 检测	检测3 区域检测 位置获取 几何形状获取 装配方式检测
物料区 固态硬盘_2 固态硬盘_2外壳 公母匹配 趋近	趋近1 位置获取 斜移
装配区 航插_2 航空插座 公母匹配 插	插4 位姿获取 位置获取 姿态角匹配 斜移
装配区 CPU_2 CPU插槽 插槽固定 对准	对准1 位姿获取 位置获取 姿态角匹配
物料区 CPU_1 CPU 插槽固定 趋近	趋近1 位置获取 斜移
中转区 软排线_3 二次定位台 贴合定位台 提	提1 竖移 缓慢 吸盘
装配区 照明连接器_3 照明连接器_3母座 公母匹配 对准	对准3 位姿获取 位置获取 姿态角匹配
物料区 CPU_8 CPU 插槽固定 趋近	趋近1 位置获取 斜移
物料区 CPU_2 CPU 插槽固定 吸取	吸取2 打开吸盘 竖移 缓慢
物料区 高压连接器3 线束 公母匹配 趋近	趋近1 位置获取 斜移
装配区 usb_1 USB母座 公母匹配 对准	对准2 位姿获取 位置获取 姿态角匹配
物料区 软排线_3 软排线公头 公母匹配 检测	检测1 区域检测 位置获取 几何形状获取
物料区 后盖3 后盖 公母匹配 趋近	趋近1 位置获取 斜移
装配区 电源键_1 电源键插槽 插槽固定 趋近	趋近3 位置获取 斜移
物料区 din连接器2 din连接器公头 公母匹配 趋近	趋近1 位置获取 斜移
装配区 CPU_1 CPU插槽 插槽固定 检测	检测3 区域检测 位置获取 几何形状获取 装配方式检测
物料区 手机电池_1 手机电池 插槽固定 检测	检测1 区域检测 位置获取 几何形状获取
装配区 同轴线_1 同轴线母座 公母匹配 插	插3 位姿获取 位置获取 姿态角匹配 斜移
物料区 后摄1 后摄 公母匹配 趋近	趋近1 位置获取 斜移
物料区 马达_2 马达 公母匹配 抓取	抓取1 关闭夹爪 夹爪1 竖移 缓慢
物料区 电池连接器2 电池 公母匹配 提	提2 竖移 缓慢 夹爪1
物料区 后盖1 后盖 公母匹配 吸取	吸取2 打开吸盘 竖移 缓慢
物料区 小板盖1 小板盖 公母匹配 吸取	吸取2 打开吸盘 竖移 缓慢
物料区 同轴线_1 同轴线公头 公母匹配 提	提3 竖移 缓慢 夹爪3
装配区 usb_3 USB母座 公母匹配	检测 趋近 对准 插
物料区 PCB板_2 PCB板_2 插槽固定 抓取	抓取2 关闭夹爪 夹爪2 竖移 缓慢
装配区 内存条_1 内存条插槽 插槽固定 趋近	趋近3 位置获取 斜移
装配区 视频信号连接器_3 视频信号连接器_3母座 公母匹配 对准	对准2 位姿获取 位置获取 姿态角匹配
物料区 后盖3 后盖 公母匹配 吸取	吸取2 打开吸盘 竖移 缓慢
装配区 高压连接器2 高压连接器 公母匹配 对准	对准3 位姿获取 位置获取 姿态角匹配
装配区 电池连接器5 电池连接器 公母匹配 趋近	趋近3 位置获取 斜移
物料区 光纤连接器3 光纤 公母匹配	检测 趋近 抓取 提
装配区 CPU_9 CPU插槽 插槽固定	检测 趋近 对准 放 压
物料区 屏幕3 屏幕 公母匹配 检测	检测1 区域检测 位置获取 几何形状获取
物料区 usb_4 USB公头 公母匹配 检测	检测1 区域检测 位置获取 几何形状获取
物料区 固态硬盘_1 固态硬盘_1外壳 公母匹配 检测	检测1 区域检测 位置获取 几何形状获取
装配区 手机电池3 手机电池槽 公母匹配 压	压3 打开推杆 竖移 缓慢
装配区 高压连接器8 高压连接器 公母匹配 推	推2 打开推杆 竖移 缓慢
装配区 以太网连接器_1 Rj45插孔 公母匹配 趋近	趋近3 位置获取 斜移
物料区 手机电池2 手机电池 公母匹配 提	提1 竖移 缓慢 吸盘
物料区 CPU_2 CPU 插槽固定 趋近	趋近1 位置获取 斜移
物料区 CPU_10 CPU 插槽固定	检测 趋近 吸取 提
物料区 电池连接器5 电池 公母匹配 检测	检测1 区域检测 位置获取 几何形状获取
物料区 电池连接器3 电池 公母匹配 提	提2 竖移 缓慢 夹爪1
物料区 前摄1 前摄 公母匹配	检测 趋近 吸取 提
物料区 固态硬盘_4 固态硬盘_3外壳 公母匹配 趋近	趋近1 位置获取 斜移
装配区 屏幕1 中框 公母匹配 对准	对准1 位姿获取 位置获取 姿态角匹配
装配区 CPU_6 CPU插槽 插槽固定 对准	对准1 位姿获取 位置获取 姿态角匹配
装配区 手机电池3 手机电池槽 公母匹配 趋近	趋近3 位置获取 斜移
物料区 电池连接器5 电池 公母匹配 抓取	抓取1 关闭夹爪 夹爪1 竖移 缓慢
装配区 PCB板_2 PCB板_2槽位 插槽固定 趋近	趋近3 位置获取 斜移
装配区 din连接器2 din连接器母头 公母匹配 检测	检测3 区域检测 位置获取 几何形状获取 装配方式检测
物料区 CPU_10 CPU 插槽固定 趋近	趋近1 位置获取 斜移
装配区 咬接铆钉_1 装配孔 孔轴连接 插	插4 位姿获取 位置获取 姿态角匹配 斜移
装配区 咬接铆钉_1 装配孔 孔轴连接 对准	对准3 位姿获取 位置获取 姿态角匹配
物料区 马达_1 马达 公母匹配 趋近	趋近1 位置获取 斜移
物料区 马达_2 马达 公母匹配	检测 趋近 抓取 提
装配区 内存条_1 内存条插槽 插槽固定 插	插5 位姿获取 位置获取 姿态角匹配 斜移
装配区 CPU_9 CPU插槽 插槽固定 压	压2 打开推杆 竖移 缓慢
装配区 软排线_2 软排线母头 公母匹配	检测 趋近 拉 对准 放 压 推
中转区 软排线_4 二次定位台 贴合定位台	检测 趋近 调姿 放 吸取 提
物料区 后盖2 后盖 公母匹配 吸取	吸取2 打开吸盘 竖移 缓慢
装配区 高压连接器1 高压连接器 公母匹配 插	插4 位姿获取 位置获取 姿态角匹配 斜移
物料区 主板1 主板 公母匹配 趋近	趋近1 位置获取 斜移
物料区 视频信号连接器_1 视频信号连接器_1公头 公母匹配 提	提2 竖移 缓慢 夹爪1
物料区 内存条_1 内存条 插槽固定 趋近	趋近1 位置获取 斜移
装配区 CPU_7 CPU插槽 插槽固定 压	压2 打开推杆 竖移 缓慢
装配区 光纤连接器5 光纤连接器 公母匹配 检测	检测3 区域检测 位置获取 几何形状获取 装配方式检测
物料区 CPU_2 CPU 插槽固定	检测 趋近 吸取 提
装配区 航插_2 航空插座 公母匹配 对准	对准3 位姿获取 位置获取 姿态角匹配
物料区 手机电池3 手机电池 公母匹配	检测 趋近 吸取 提
装配区 以太网连接器_1 Rj45插孔 公母匹配	检测 趋近 对准 插
装配区 高压连接器2 高压连接器 公母匹配 检测	检测3 区域检测 位置获取 几何形状获取 装配方式检测
装配区 屏幕3 中框 公母匹配	检测 趋近 对准 放 压
装配区 PCB板_1 PCB板_1槽位 插槽固定 检测	检测3 区域检测 位置获取 几何形状获取 装配方式检测
物料区 视频信号连接器_1 视频信号连接器_1公头 公母匹配 抓取	抓取1 关闭夹爪 夹爪1 竖移 缓慢
装配区 手机电池1 手机电池槽 公母匹配 压	压3 打开推杆 竖移 缓慢
装配区 后摄2 后摄孔 公母匹配 检测	检测3 区域检测 位置获取 几何形状获取 装配方式检测
物料区 din连接器1 din连接器公头 公母匹配 检测	检测1 区域检测 位置获取 几何形状获取
装配区 软管插头_1 软管插座 公母匹配 趋近	趋近3 位置获取 斜移
物料区 听筒1 听筒 公母匹配 抓取	抓取2 关闭夹爪 夹爪2 竖移 缓慢
装配区 照明连接器_1 照明连接器_1母座 公母匹配 插	插2 位姿获取 位置获取 姿态角匹配 斜移
物料区 后摄1 后摄 公母匹配 吸取	吸取2 打开吸盘 竖移 缓慢
装配区 usb_4 USB母座 公母匹配 插	插2 位姿获取 位置获取 姿态角匹配 斜移
装配区 usb_5 USB母座 公母匹配 检测	检测3 区域检测 位置获取 几何形状获取 装配方式检测
物料区 光纤连接器2 光纤 公母匹配 检测	检测1 区域检测 位置获取 几何形状获取
装配区 电池连接器4 电池连接器 公母匹配 趋近	趋近3 位置获取 斜移
装配区 听筒_1 听筒 插槽固定 对准	对准1 位姿获取 位置获取 姿态角匹配
物料区 后摄1 后摄 公母匹配	检测 趋近 吸取 提
物料区 usb_3 USB公头 公母匹配 抓取	抓取1 关闭夹爪 夹爪1 竖移 缓慢
物料区 照明连接器_2 照明连接器_2公头 公母匹配 趋近	趋近1 位置获取 斜移
装配区 软排线_2 软排线母头 公母匹配 推	推1 打开推杆 竖移 缓慢
装配区 sim卡托2 sim卡槽 公母匹配 检测	检测3 区域检测 位置获取 几何形状获取 装配方式检测
装配区 光纤连接器1 光纤连接器 公母匹配	检测 趋近 对准 插
装配区 usb_3 USB母座 公母匹配 趋近	趋近3 位置获取 斜移
装配区 CPU_8 CPU插槽 插槽固定 压	压2 打开推杆 竖移 缓慢
物料区 din连接器1 din连接器公头 公母匹配 提	提2 竖移 缓慢 夹爪1
装配区 马达_1 马达槽 公母匹配 趋近	趋近3 位置获取 斜移
中转区 前摄2 二次定位台 贴合定位台 调姿	调姿1 位姿获取 姿态角匹配
装配区 PCB板_1 PCB板_1槽位 插槽固定 趋近	趋近3 位置获取 斜移
装配区 同轴线_1 同轴线母座 公母匹配 推	推2 打开推杆 竖移 缓慢
装配区 后盖1 中框 公母匹配 检测	检测3 区域检测 位置获取 几何形状获取 装配方式检测
装配区 usb_5 USB母座 公母匹配 趋近	趋近3 位置获取 斜移
装配区 高压连接器9 高压连接器 公母匹配 对准	对准3 位姿获取 位置获取 姿态角匹配
装配区 usb_2 USB母座 公母匹配 检测	检测3 区域检测 位置获取 几何形状获取 装配方式检测
装配区 固态硬盘_4 PCI-E母头 公母匹配 对准	对准4 位姿获取 位置获取 姿态角匹配
装配区 光纤连接器4 光纤连接器 公母匹配 插	插4 位姿获取 位置获取 姿态角匹配 斜移
物料区 前摄1 前摄 公母匹配 趋近	趋近1 位置获取 斜移
装配区 usb_3 USB母座 公母匹配 对准	对准2 位姿获取 位置获取 姿态角匹配
物料区 高压连接器7 线束 公母匹配	检测 趋近 夹取 提
装配区 视频信号连接器_1 视频信号连接器_1母座 公母匹配	检测 趋近 对准 插
物料区 CPU_4 CPU 插槽固定	检测 趋近 吸取 提
物料区 照明连接器_1 照明连接器_1公头 公母匹配 抓取	抓取1 关闭夹爪 夹爪1 竖移 缓慢
装配区 软排线_1 软排线母头 公母匹配 趋近	趋近3 位置获取 斜移
物料区 照明连接器_1 照明连接器_1公头 公母匹配 检测	检测1 区域检测 位置获取 几何形状获取
物料区 CPU_5 CPU 插槽固定 提	提1 竖移 缓慢 吸盘
装配区 电池连接器4 电池连接器 公母匹配 对准	对准3 位姿获取 位置获取 姿态角匹配
装配区 马达_1 马达槽 公母匹配 对准	对准3 位姿获取 位置获取 姿态角匹配
装配区 光纤连接器2 光纤连接器 公母匹配 趋近	趋近3 位置获取 斜移
装配区 屏幕2 中框 公母匹配 对准	对准1 位姿获取 位置获取 姿态角匹配
物料区 din连接器3 din连接器公头 公母匹配 提	提2 竖移 缓慢 夹爪1
物料区 主板1 主板 公母匹配	检测 趋近 抓取 提
装配区 视频信号连接器_2 视频信号连接器_2母座 公母匹配 趋近	趋近3 位置获取 斜移
装配区 高压连接器6 高压连接器 公母匹配 趋近	趋近3 位置获取 斜移
物料区 听筒_1 听筒 插槽固定 趋近	趋近1 位置获取 斜移
物料区 屏幕1 屏幕 公母匹配	检测 趋近 吸取 提
物料区 光纤连接器3 光纤 公母匹配 检测	检测1 区域检测 位置获取 几何形状获取
装配区 软管插头_1 软管插座 公母匹配 检测	检测3 区域检测 位置获取 几何形状获取 装配方式检测
中转区 软排线_2 二次定位台 贴合定位台 检测	检测2 区域检测 位置获取
装配区 光纤连接器2 光纤连接器 公母匹配 检测	检测3 区域检测 位置获取 几何形状获取 装配方式检测
装配区 CPU_6 CPU插槽 插槽固定	检测 趋近 对准 放 压
物料区 手机电池_1 手机电池 插槽固定	检测 趋近 抓取 提
物料区 电池连接器4 电池 公母匹配 检测	检测1 区域检测 位置获取 几何形状获取
中转区 同轴线_1 二次定位台 贴合定位台	检测 趋近 调姿 放 夹取 提
装配区 手机电池1 手机电池槽 公母匹配 对准	对准1 位姿获取 位置获取 姿态角匹配
装配区 usb_4 USB母座 公母匹配 检测	检测3 区域检测 位置获取 几何形状获取 装配方式检测
物料区 马达_1 马达 公母匹配 提	提2 竖移 缓慢 夹爪1
物料区 LSA连接器_1 LSA插头 公母匹配	检测 趋近 抓取 提
物料区 din连接器1 din连接器公头 公母匹配 抓取	抓取1 关闭夹爪 夹爪1 竖移 缓慢
物料区 固态硬盘_2 固态硬盘_2外壳 公母匹配	检测 趋近 夹取 提
物料区 PCB板_1 PCB板_1 插槽固定 检测	检测1 区域检测 位置获取 几何形状获取
装配区 手机电池1 手机电池槽 公母匹配	检测 趋近 对准 放 压
物料区 CPU_9 CPU 插槽固定 趋近	趋近1 位置获取 斜移
物料区 usb_1 USB公头 公母匹配 检测	检测1 区域检测 位置获取 几何形状获取
装配区 高压连接器5 高压连接器 公母匹配 对准	对准3 位姿获取 位置获取 姿态角匹配
物料区 软排线_1 软排线公头 公母匹配 检测	检测1 区域检测 位置获取 几何形状获取
装配区 CPU_9 CPU插槽 插槽固定 检测	检测3 区域检测 位置获取 几何形状获取 装配方式检测
装配区 CPU_9 CPU插槽 插槽固定 趋近	趋近3 位置获取 斜移
物料区 CPU_5 CPU 插槽固定 检测	检测1 区域检测 位置获取 几何形状获取
装配区 光纤连接器5 光纤连接器 公母匹配 推	推3 打开推杆 竖移 缓慢
中转区 同轴线_1 二次定位台 贴合定位台 调姿	调姿2 位姿获取 姿态角匹配
装配区 din连接器3 din连接器母头 公母匹配 推	推2 打开推杆 竖移 缓慢
装配区 sim卡托2 sim卡槽 公母匹配 趋近	趋近3 位置获取 斜移
装配区 电池连接器2 电池连接器 公母匹配 对准	对准3 位姿获取 位置获取 姿态角匹配
物料区 电池连接器4 电池 公母匹配 抓取	抓取1 关闭夹爪 夹爪1 竖移 缓慢
装配区 usb_5 USB母座 公母匹配 插	插2 位姿获取 位置获取 姿态角匹配 斜移
装配区 螺丝_1 装配孔 孔轴连接 趋近	趋近3 位置获取 斜移
物料区 usb_1 USB公头 公母匹配	检测 趋近 抓取 提
装配区 软排线_4 软排线母头 公母匹配 推	推1 打开推杆 竖移 缓慢
